################
#......###.....#
#............#.#
#..#..#..##..#.#
#..##...#.#....#
#.......#....###
#............###
#....##..#..#.##
###..#..##.....#
################
