################
#......#.......#
#............#.#
#..#.....##..#.#
#..##...#.#....#
#.......#....###
################
